844444444444444444444444444447
311111111111111111111111111113
311111111111111111111111111113
311111111111111111111111111113
311111111111111111111111111113
311111122222222222111111111113
311111121111111112111111111113
311111121111111112111111111113
311111121111111112111111111113
311111221111111112111111111113
311111221111111112111111111113
311111211111111112111111111113
311111211111111112221111111113
311111211111111111121111111113
311111211111111111121111111113
311111211111111111121111111113
311111211111111111121111111113
311111222222222222221111111113
311111111111111111111111111113
311111111111111111111111111113
311111111111111111111111111113
311111111111111111111111111113
311111111111111111111111111113
311111111111111111111111111113
311111111111111111111111111113
311111111111111111111111111113
311111111111111111111111111113
311111111111111111111111111113
311111111111111111111111111113
644444444444444444444444444445